***********
*...___...*
*.........*
*...*.....*
*...*.M...*
*******F***
Player 1: 1,3
Player 2: 2,4
